0 0 0 0 0 0 0 1 0 0 0 0 0 0 1 0 0 0 0 4 4 9 9 9 9 9 9 9 9 9 9 9 9 9 9 4 4 9 9 9 9 9 9 9 9 9 9 9 9 9
0 0 1 1 1 1 1 1 0 6 6 6 6 0 1 1 1 1 1 1 4 4 9 9 9 9 9 9 9 9 9 9 9 9 4 4 9 9 9 9 9 9 9 9 9 9 9 9 9 9
0 0 0 0 0 0 0 1 0 6 7 7 6 0 1 0 0 0 0 0 0 4 4 6 6 6 6 6 6 6 6 6 6 4 4 9 9 9 9 9 9 9 9 9 9 9 9 9 9 9
0 0 6 6 6 6 0 0 0 6 7 7 6 0 0 0 6 6 6 6 0 9 6 9 9 9 9 9 9 9 9 9 9 6 9 9 9 9 9 9 9 9 9 9 9 9 9 9 9 9
0 0 6 7 7 7 6 6 6 6 7 7 6 6 6 6 7 7 7 6 0 9 6 9 9 4 4 4 4 4 4 9 9 9 6 6 6 6 6 6 6 6 6 6 6 6 6 6 6 6
0 0 6 7 7 7 7 7 7 7 7 7 7 7 7 7 7 7 7 6 0 9 6 4 4 9 9 4 4 9 9 4 4 9 7 7 7 7 7 7 7 7 7 7 7 7 7 7 7 7
0 0 6 7 7 7 7 7 7 7 7 7 7 7 7 7 7 7 7 6 0 9 6 4 4 9 9 4 4 9 9 4 4 9 7 7 7 7 7 7 7 7 7 7 7 7 7 7 7 7
0 0 6 7 7 7 6 6 6 6 7 7 6 6 6 6 7 7 7 6 0 9 6 9 9 4 4 4 4 4 4 9 9 9 6 6 6 6 6 6 6 6 6 6 6 6 6 6 6 6
0 0 6 6 6 6 0 0 0 6 7 7 6 0 0 0 6 6 6 6 0 9 6 9 9 9 4 4 4 4 9 9 9 6 9 9 9 9 9 9 9 9 9 9 9 9 9 9 9 9
0 0 0 0 0 0 0 1 0 6 7 7 6 0 1 0 0 0 0 0 0 9 9 6 6 6 9 9 9 9 6 6 6 9 9 9 9 9 9 9 9 9 9 9 9 9 9 9 9 9
0 0 1 1 1 1 1 1 0 6 7 7 6 0 1 1 1 1 1 1 0 9 9 4 4 6 9 9 9 9 6 9 9 4 4 9 9 9 9 9 9 9 9 9 9 9 9 9 9 9
0 0 0 0 0 0 0 1 0 6 7 7 6 0 1 0 0 0 0 0 0 9 4 4 9 6 4 4 4 4 6 9 9 9 4 4 9 9 9 9 9 9 9 9 9 9 9 9 9 9
0 0 0 0 0 0 0 0 6 1 7 7 1 6 0 0 0 0 0 0 0 4 4 9 9 6 4 4 4 4 6 9 9 9 9 4 4 9 9 9 9 9 9 9 9 9 9 9 9 9
0 0 0 0 0 0 0 6 1 7 7 7 7 1 6 0 0 0 0 0 0 0 0 0 0 6 7 7 7 7 6 0 0 0 0 0 0 0 0 0 0 0 0 0 0 0 0 0 0 0
0 0 0 0 0 0 6 1 7 7 7 7 7 7 1 6 0 0 0 0 0 0 0 0 0 6 7 7 7 7 6 0 0 0 0 0 0 0 0 0 0 0 0 0 0 0 0 0 0 0
0 0 0 0 0 0 6 7 7 7 7 7 7 7 7 6 0 0 0 0 0 0 0 0 1 6 7 7 7 7 6 1 0 0 0 0 0 0 0 0 0 0 0 0 0 0 0 0 0 0
0 0 0 0 0 0 6 7 7 7 7 7 7 7 7 6 0 0 0 0 0 0 0 1 6 7 7 7 7 7 7 6 1 0 0 0 0 0 0 0 0 0 0 0 0 0 0 0 0 0
0 0 0 0 0 0 6 7 7 7 7 7 7 7 7 6 0 0 0 0 0 0 0 6 7 7 7 7 7 7 7 7 6 0 0 0 0 0 0 0 0 0 0 0 0 0 0 0 0 0
0 0 0 0 0 0 6 7 7 7 7 7 7 7 7 6 0 0 0 0 0 0 0 6 7 7 7 7 7 7 7 7 6 0 0 0 0 0 0 0 0 0 0 0 0 0 0 0 0 0
0 0 0 0 0 0 6 7 7 7 7 7 7 7 7 6 0 0 0 0 0 0 0 6 7 7 7 7 7 7 7 7 6 0 0 0 0 0 0 0 0 0 0 0 0 0 0 0 0 0
0 0 0 0 0 0 6 7 7 7 7 7 7 7 7 6 0 0 0 0 0 0 0 6 7 7 7 7 7 7 7 7 6 0 0 0 0 0 0 0 0 0 0 0 0 0 0 0 0 0
0 0 0 0 0 0 6 1 7 7 7 7 7 7 1 6 0 0 0 0 0 0 0 6 7 7 7 7 7 7 7 7 6 0 0 0 0 0 0 0 0 0 0 0 0 0 0 0 0 0
0 0 0 0 0 0 0 6 1 7 7 7 7 1 6 0 0 0 0 0 0 0 0 6 7 7 7 7 7 7 7 7 6 0 0 0 0 0 0 0 0 0 0 0 0 0 0 0 0 0
0 0 0 0 0 0 0 0 6 1 7 7 1 6 0 0 0 0 0 0 0 0 0 6 7 7 7 7 7 7 7 7 6 0 0 0 0 0 0 0 0 0 0 0 0 0 0 0 0 0
0 0 0 0 0 0 0 0 0 6 7 7 6 0 0 0 0 0 0 0 0 0 0 6 7 7 7 7 7 7 7 7 6 0 0 0 0 0 0 0 0 0 0 0 0 0 0 0 0 0
0 0 0 0 0 0 0 0 0 6 7 7 6 0 0 0 0 0 0 0 0 0 0 6 7 7 7 7 7 7 7 7 6 0 0 0 0 0 0 0 0 0 0 0 0 0 0 0 0 0
0 0 0 0 0 0 0 0 0 6 7 7 6 6 6 6 6 0 0 0 0 0 0 6 1 7 7 7 7 7 7 1 6 0 0 0 0 0 0 0 0 0 0 0 0 0 0 0 0 0
0 0 0 0 0 0 0 0 0 6 7 7 7 7 7 7 6 0 0 0 0 0 0 0 6 1 6 7 7 6 1 6 0 0 0 0 0 0 0 0 0 0 0 0 0 0 0 0 0 0
0 0 0 0 0 0 0 0 0 6 7 7 7 7 7 7 6 0 0 0 0 0 0 0 0 6 1 7 7 1 6 6 0 0 0 0 0 0 0 0 0 0 0 0 0 0 0 0 0 0
0 0 0 0 0 0 0 0 0 6 6 6 6 6 7 7 6 0 0 0 0 0 0 0 0 6 1 7 7 1 6 0 0 0 0 0 0 0 0 0 0 0 0 0 0 0 0 0 0 0
0 0 0 0 0 0 0 0 0 0 0 0 6 1 7 7 1 6 0 0 0 0 0 0 0 6 1 7 7 1 6 0 0 0 0 0 0 0 0 0 0 0 0 0 0 0 0 0 0 0
0 0 0 0 0 0 0 0 0 0 0 6 1 7 7 7 7 1 6 0 0 0 0 0 0 6 1 7 7 1 6 0 0 0 0 0 0 0 0 0 0 0 0 0 0 0 0 0 0 0
0 0 0 0 0 0 0 0 0 0 6 1 7 7 7 7 7 7 1 6 0 0 0 0 6 1 7 7 7 7 1 6 0 0 0 0 0 0 0 0 0 0 0 0 0 0 0 0 0 0
0 0 0 0 0 0 0 0 0 0 6 7 7 7 7 7 7 7 7 6 0 0 0 0 6 7 7 7 7 7 7 6 0 0 0 0 0 0 0 0 0 0 0 0 0 0 0 0 0 0
0 0 0 0 0 0 0 0 0 0 6 7 7 7 7 7 7 7 7 6 0 0 0 0 6 7 7 7 7 7 7 6 0 0 0 0 0 0 0 0 0 0 0 0 0 0 0 0 0 0
0 0 0 0 0 0 0 0 0 0 6 7 7 7 7 7 7 7 7 6 0 0 0 0 6 7 7 7 7 7 7 6 0 0 0 0 0 0 0 0 0 0 0 0 0 0 0 0 0 0
0 0 0 0 0 0 0 0 0 0 6 7 7 7 7 7 7 7 7 6 0 0 0 0 6 7 7 7 7 7 7 6 0 0 0 0 0 0 0 0 0 0 0 0 0 0 0 0 0 0
0 0 0 0 0 0 0 0 0 0 6 7 7 7 7 7 7 7 7 6 0 0 0 0 6 7 7 7 7 7 7 6 0 0 0 0 0 0 0 0 0 0 0 0 0 0 0 0 0 0
0 0 0 0 0 0 0 0 0 0 6 7 7 7 7 7 7 7 7 6 0 0 0 0 6 7 7 7 7 7 7 6 0 0 0 0 0 0 0 0 0 0 0 0 0 0 0 0 0 0
0 0 0 0 0 0 0 0 0 0 6 7 7 7 7 7 7 7 7 6 0 0 0 0 6 7 7 7 7 7 7 6 0 0 0 0 0 0 0 0 0 0 0 0 0 0 0 0 0 0
0 0 0 0 0 0 0 0 0 0 6 7 7 7 7 7 7 7 7 6 0 0 0 0 6 7 7 7 7 7 7 6 0 0 0 0 0 0 0 0 0 0 0 0 0 0 0 0 0 0
0 0 0 0 0 0 0 0 0 0 6 1 7 7 7 7 7 7 1 6 0 0 0 0 6 7 7 7 7 7 7 6 0 0 0 0 0 0 0 0 0 0 0 0 0 0 0 0 0 0
0 0 0 0 0 0 0 0 0 0 0 6 1 7 7 7 7 1 6 0 0 0 0 0 6 1 7 7 7 7 1 6 0 0 0 0 0 0 0 0 0 0 0 0 0 0 0 0 0 0
0 0 0 0 0 0 0 0 0 0 0 0 6 1 7 7 1 6 0 0 0 0 0 0 6 6 1 7 7 1 6 6 0 0 0 0 0 0 0 0 0 0 0 0 0 0 0 0 0 0
0 0 0 0 0 0 0 0 0 0 0 0 0 6 7 7 6 0 0 0 0 0 0 0 0 0 6 7 7 6 0 0 0 0 0 0 0 0 0 0 0 0 0 0 0 0 0 0 0 0
0 0 0 0 0 0 0 0 0 0 0 0 0 6 7 7 6 6 6 6 6 6 6 6 6 6 6 7 7 6 0 0 0 0 0 0 0 0 0 0 0 0 0 0 0 0 0 0 0 0
0 0 0 0 0 0 0 0 0 0 0 0 0 6 7 7 7 7 7 7 7 7 7 7 7 7 7 7 7 6 0 0 0 0 0 0 0 0 0 0 0 0 0 0 0 0 0 0 0 0
0 0 0 0 0 0 0 0 0 0 0 0 0 6 7 7 7 7 7 7 7 7 7 7 7 7 7 7 7 6 0 0 0 0 0 0 0 0 0 0 0 0 0 0 0 0 0 0 0 0
0 0 0 0 0 0 0 0 0 0 0 0 0 6 6 6 6 6 6 6 6 6 6 6 6 6 6 6 6 6 0 0 0 0 0 0 0 0 0 0 0 0 0 0 0 0 0 0 0 0
0 0 0 0 0 0 0 0 0 0 0 0 0 0 0 0 0 0 0 0 0 0 0 0 0 0 0 0 0 0 0 0 0 0 0 0 0 0 0 0 0 0 0 0 0 0 0 0 0 0